41
15
8 8 8 13 8 8 8 8 8 8 8 13 8 8 13 8 8 8 13 8 8 8 8 13 8 63 14 15 15 15 15 15 15 15 15 15 15 15 15 15 71 
8 8 8 8 13 13 8 8 8 13 8 8 8 8 8 8 13 13 8 8 8 8 8 13 8 63 0 0 0 0 0 0 0 0 0 0 0 0 0 0 71 
1 2 1 2 1 2 1 2 1 2 1 2 1 2 1 2 1 2 1 2 1 2 1 2 1 2 0 0 0 0 0 0 0 0 0 0 0 0 0 0 71 
14 16 14 16 14 16 5 16 14 16 14 16 5 4 14 16 5 4 14 16 14 16 14 16 5 4 0 0 0 0 0 0 0 0 0 0 50 51 52 48 71 
0 0 0 0 0 0 0 0 0 0 0 0 0 0 0 0 0 0 0 0 0 0 0 0 0 0 0 0 0 0 0 0 0 0 0 0 0 0 22 49 71 
77 77 77 77 77 81 0 0 0 0 0 0 0 0 0 0 0 0 0 0 0 0 0 0 0 0 0 0 0 0 0 0 0 0 0 0 53 0 23 0 71 
13 8 8 13 8 63 0 0 0 0 0 0 0 0 0 0 0 0 0 0 0 0 0 0 0 0 0 0 0 0 0 0 0 0 0 0 0 72 73 0 71 
13 13 7 13 13 63 0 46 0 0 0 0 0 42 43 0 0 0 0 0 0 47 44 40 0 0 0 0 0 0 0 0 0 40 0 0 0 71 63 0 71 
13 8 13 13 13 63 0 0 0 24 0 0 0 0 0 25 26 0 0 0 0 0 0 0 0 0 0 0 29 30 0 0 0 0 27 28 0 71 63 0 71 
7 8 8 7 8 63 65 68 54 55 55 55 55 55 55 55 56 0 0 0 0 64 75 75 76 0 0 0 57 59 0 0 0 69 70 70 74 71 63 74 71 
39 39 39 39 39 86 10 11 87 39 39 39 39 39 39 39 86 10 11 10 11 87 39 39 86 11 10 10 87 86 10 10 10 87 39 39 39 39 86 39 37 
12 12 12 12 12 12 12 12 12 12 12 12 12 12 12 12 12 12 12 12 12 12 12 12 12 12 12 12 12 12 12 12 12 12 12 12 12 12 12 12 37 
12 12 12 12 12 12 12 12 12 12 12 12 12 12 12 12 12 12 12 12 12 12 12 12 12 12 12 12 12 12 12 12 12 12 12 12 12 12 12 12 37 
12 12 12 12 12 12 12 12 12 12 12 12 12 12 12 12 12 12 12 12 12 12 12 12 12 12 12 12 12 12 12 12 12 12 12 12 12 12 12 12 37 
12 12 12 12 12 12 12 12 12 12 12 12 12 12 12 12 12 12 12 12 12 12 12 12 12 12 12 12 12 12 12 12 12 12 12 12 12 12 12 12 37 
